id	name	population	
USA	USA	"1"	
RUS	Russia	"1"	
IRE	Ireland	"1"	
CHL	Chile	"1"	
PRK	North Korea	"1"	
GBR	England	"1"	
NGA	Nigeria	"1"	
MEX	Mexico	"1"	
NOR	Norway	"1"	
KOR	South Korea	"1"	
ISL	Iceland	"1"	
FRA	France	"1"	
JPN	Japan	"1"	
GER	Germany	"1"	
ITA	Italy	"1"	
SWE	Sweden	"1"	
ESP	Spain	"1"	
ISR	Israel	"1"	
AUT	Austria	"1"	
BRA	Brazil	"1"	
COL	Colombia	"1"	
ARG	Argentina	"1"	
POL	Poland	"1"	
CAN	Canada	"1"	
PRT	Portugal	"1"	
IRN	Iran	"1"